NO textures/wall_textures/wall.png
EA textures/wall_textures/wall4.png
SO textures/wall_textures/wall2.png
WE textures/wall_textures/wall3.png

F 220,100,0
C 225,30,0

1111111111111111111111111111111111111111111111111111
1011110000000000000000000000000000000000000000000011
1011110000000000000000000000000000000000000000000011
1000000000000000001111111111111110000000000000000001
10000000000000000000000000000000000000000X0000000001
100000000X0000000000000Z000000000000000000Y000000001
1111111000111100111110000000111111111111111111111111
      10001  1001   100000001  0000
      10001111001111100000001
      10000000000000000000Y01
      1N001111111111100000001
      11111         111111111