NO textures/wall_textures/wall.png
EA textures/wall_textures/wall4.png
SO textures/wall_textures/wall2.png
WE textures/wall_textures/wall3.png

F 220,100,0
C 225,30,0

        1111111111111111111111111
        1100000000110000000111D11
        10000000011100000D0110001
        1001000000000000000110001
111111111011000001110000000000001
110000000011000001110111111111111
11110111111111011100000010001
111101111111110111D1010010001
1100000011010101110000001D001
1100D000100000001100000000001
11000000000100001101010010001
11000001110101011111D11110N0111
11110111 111D101 101111010001
11111111 1111111 111111111111
