NO textures/wall_textures/wall.png
EA textures/wall_textures/wall4.png
SO textures/wall_textures/wall2.png
WE textures/wall_textures/wall3.png

F 220,100,0
C 225,30,0

        1111111111111111111111111
        1100000000110000000111011
        1000000001110000000110001
        1001000000000000000110001
111111111011000001110000000000001
110000000011000001110111111111111
111101111111110111000000100X1
111101111111110111D1111110001
11000000110101011100Z0001D111
1100000010000000110001D110001
11000000000100001111D10010001
1100000111010101110001X010001
11110111 111011 100X1100D0N1
11111111 1111111 111111111111
