SO textures/wall_textures/wall2.png
NO textures/wall_textures/wall.png
WE textures/wall_textures/wall3.png
EA textures/wall_textures/wall4.png

F 255,100,0
C 225,30,0

111111111
100000001
1000Y0001
100000001
100000001
100000001
100000001
100000001
100000001
100000001
1000N0001
111111111