NO txt/wall_textures/wall.png
EA txt/wall_textures/wall4.png
SO txt/wall_textures/wall2.png
WE txt/wall_textures/wall3.png

F 135,109,70
C 181,171,107

111111111111111
10YXXZZZYYYYY11
1XXYXZYZXXZ0011
10XYXZYZ0ZY0011
1YZYXZXYZXYZY11
1YZXZZYZZXYXY11
1YXYYXYZXYZ0Y11
1YZXYZXYZ0YYXY1
1XYYYXZYXXZXY11
1YXYYZZZXXY0X11
100000000000011
100000000000001
1111D1D1D1D1101
10ND00000000001
111111111111111