NO textures/wall_textures/wall.png
SO textures/wall_textures/wall2.png
WE textures/wall_textures/wall3.png
EA textures/wall_textures/wall4.png

F 220,100,0
C 225,30,0

11111111111111111111
1XD0D010DZ10D010D001
1D111D1D1D1D1D1011D1
1X1Y101010101Z1D11Y1
1D1X1D1D1D1D1D1011D1
101X101Y10101Y1D1101
1D1Z1D1D1D1D1D1Z11D1
1X1X1Y101Z10101D11X1
1D1Y1D1D1D1D1D101XX1
101Y1Y1Y1010101D1D11
1D1X1D1D1D1D1D1Z1011
101Y1Y1010101Y1D1D11
1D1Y1D1D1D1D1D101011
1Z1Y1Y1X1Z1Y101D1D11
1D1X1D1D1D101D1Z1Z11
101Z1010101D101D1D11
1D1Z10DZ10D01ZD01011
10101111111111111D11
1N100000000000D0D011
11111111111111111111