NO txt/wall_textures/wall.png
EA txt/wall_textures/wall4.png
SO txt/wall_textures/wall2.png
WE txt/wall_textures/wall3.png

F 135,109,70
C 181,171,107

1111111111111111111
100Y0000X000000X001
1000000000000000001
1000000000000000001
1000000000000000001
1000000000000000001
10000000000000011D1
10000000N00000010Y1
1111111111111111111
