NO ./path_to_the_north_texture
SO ./path_to_the_south_texture
WE ./path_to_the_west_texture
EA ./path_to_the_east_texture

F 220,100,0
C 225,30,0


        1111111111111111111111111
        1000000000110000000000001
        1011000001110000000000001
        1001000000000000000000001
111111111011000001110000000000001
100000000011000001110111111111111
11110111111111011100000010001
11110111111111011101010010001
11000000110101011100000010001
10000000000000000000000000001
100000000N0000001101010010001
110000011010101111101100000111
10110000011101010101111010001
10000000000000000000000000001
11111110011111100111111111111
11000000010101011100000010001
1000000000000000000000011
10000000000000001101010111111
110000011010100011101100000111
11110111111111011101010010001
11110111111111011101010010001
10000000000000000000000000001
11000000110101011100000010001
10000000000000000000000000001
10000000000000000000000000001
10000000000000000000000000001
10110111111101011100000010001
11111111 1111111 111111111111
