NO textures/wall_textures/wall.png
SO textures/wall_textures/wall2.png
WE textures/wall_textures/wall3.png
EA textures/wall_textures/wall4.png

F 220,100,0
C 225,30,0

1111111111111111111
10000000X0000000001
1000000000000000001
1000000000000000001
1000000000000000001
1000000000000000001
1000000000000000001
10000000N0000000001
1111111111111111111
