NO txt/wall_textures/wall.png
EA txt/wall_textures/wall4.png
SO txt/wall_textures/wall2.png
WE txt/wall_textures/wall3.png

F 135,109,70
C 181,171,107

11111111111111111111111111111111111111111111111111
100D000D000D000D000D000D00D00D001Z00000000000000Z1
11111D11111111111111111111111111100000000000000001
100000X0001000D000D00X00X00X00X0100000Z000Z0000001
1Z111111101111111110001110000000100000000000000001
10100000100000Z0Y1100X111D1X0X0010000000Z000000001
10101D1011111110011110110011110X100000000000000001
101Z10D0100000100D00101100001100100000111111111111
10101D10101D1010011110110Z0011001000Y0000000000001
1Z10100Z10D0D01YZ100D01111D111111000000Y0000000001
10101D111010101001111011010110001000000000Y0000001
100Z100Z0010101000X000110D00D0101000Y0000000Y00001
1111111111111D11111111111111111D10000000000000Y001
1YYYY110000000111111111000000000100000000000000001
1000011011111100D0000X111D111111111111111111000001
1000011011000D001111111110110D00100000000000000001
10000010111011001100Z00000DXZ1101X0000X00000X00001
100000101110010011001111111D111D100000000000000001
10000010110001001100100000101100100000111111111111
1000001011000D001100Z00000000010100X00000000000001
1D111D101101110011D11111111D11101000000X0000X00001
101110D0110100Z010001000Z0001000100000000000000001
1X0111111101000011111111111110011111111111111111D1
11D11100DX0100001000000000001000000000000000000001
10X1110011100Z001000000000001111111111111111111111
10011100110000001000000000000001000000X001X000X001
10X111001100000010000000000000010111110X0100111101
11D1111D110Z00001000000000000001010X00100D00X10001
1000000X1100011110000000000000010D00111111111000X1
111111111111D110D000000000000001110010D00DZ1100001
1000000D000001001000000000000001X00011100111111101
100XY011111111011000000000000001000010D00D0110X001
10010010000Y01001000000000000001000011100111100001
11D10011D110011010000000000000010X0Z10D00000111001
100111110Y01001D11111111111D111101111111111D100001
1Y0000Y0000010001XD0D00000000000000000000000111001
11111111111111111111111111111111111111111111111001
100000000D000XD0000D00011XD0D0D0D00D0D000000000001
101111111111111001110101111111111111111D1111111111
100000X0000000100Y01D110000000DZD00000001000000001
11111111111110111D1100101111111111111111100X1111D1
100X00100X0010100001111010D0010D000000001011000001
100000100000101000010000101001D11D111D111010011111
100000D00000101Y0001D11110100100100100001010010001
10000010000010100001000DY0100D0011000100D0100D0001
111D11100000101000X11111110111111011101111011110Y1
10000010000010100001111111D111111D111D1111D1111001
100W001000001010111100Y0000000D000000000010000D001
100000100X00D01000XD00000Y000010000Z00100000101011
11111111111111111111111111111111111111111111111111