NO textures/wall_textures/wall.png
EA textures/wall_textures/wall4.png
SO textures/wall_textures/wall2.png
WE textures/wall_textures/wall3.png

F 220,100,0
C 225,30,0


111111111111111111111111111111111111111111111111111111111111111111111111111
100000000000000000000000000000000000000000000000000000000000000000000000001
100000000000000000000000000000000000000000000000000000000000000000000000001
100000000000000000000000000000000000000000000000000000000000000000000000001
100000000000000000000000000000000000000000000000000000000000000000000000001
100000000000000000000000000000000000000000000000000000000000000000000000001
100000000000000000000000000000000000000000000000000000000000000000000000001
100000000000000000000000000000000000000000000000000000000000000000000000001
100000000000000000000000000000000000000000000000000000000000000000000000001
100000000000000000000000000000000000000000000000000000000000000000000000001
100000000000000000000000000000000000000000000000000000000000000000000000001
100000000000000000000000000000000000000000000000000000000000000000000000001
100000000000000000000000000000000000000000000000000000000000000000000000001
100000000000000000000000000000000000000000000000000000000000000000000000001
100000000000000000000000000000000000000000000000000000000000000000000000001
100000000000000000000000000000000000000000000000000000000000000000000000001
100000000000000000000000000000000000000000000000000000000000000000000000001
100000000000000000000000000000000000000000000000000000000000000000000000001
100000000000000000000000000000000000000000000000000000000000000000000000001
100000000000000000000000000000000000000000000000000000000000000000000000001
100000000000000000000000000000000000000000000000000000000000000000000000001
100100000000000000000000000000000000000000000000000000000000000000000000001
11D111111110000000000000000000000000000000000000000000000000000000000000001
10X001000010000000000000000000000000000000000000000000000000000000000000001
10000D0X0010000000000000000000000000000000000000000000000000000000000000001
100001000010000000000000000000000000000000000000000000000000000000000000001
11D1111D1110000000000000000000000000000000000000000000000000000000000000001
1000D0000010000000000000000000000000000000000000000000000000000000000000001
10N010000010000000000000000000000000000000000000000000000000000000000000001
111111111111111111111111111111111111111111111111111111111111111111111111111