NO txt/wall_textures/wall.png
EA txt/wall_textures/wall4.png
SO txt/wall_textures/wall2.png
WE txt/wall_textures/wall3.png

F 135,109,70
C 181,171,107

111
1S1
101
101
101
101
101
101
1X1
101
101
101
101
101
101
101
101
101
101
101
101
101
101
101
1Z1
101
10111
10001
11001
 1001
 1001
 1001
 1001
 1Y01
 1001
 1001
 1001
 1001
 1001
 1001
 1001
 1001
 1001
 1001
 1001
 1001
 10011
 10001
 10101
 101Z1
 10101
 10101
 10101
 10101
 1Z101
 10101
 10101
 10101
 10101
 10101
 10101
 10101
 10101
 10101
 10101
 10101
 10101111111
 10100000001
 10101111101
 10101   101
 1Y101   101
 101Y1   101
 10111   1Y1
 101  111101
 101  100001
 101  101111
 101  101
 101  101
 101  101
 101  101
 1Z1  101
 101  101
 101  101
 101  101
 101  101
 101  101
 101  101
 101  101
 101  101
 101  101
1101  101
1001  101
1011111011111111111111111111111111111111111111111111111
100000000000Z000000000000000000000Z000000000000000000Z1
1011111011111111111111111111111111111111111111111111101
101   101                                           101
101   101                                           101
1Z1   101                                           101
101   101                                           101
101   101                                           101
101   101                                           101
101   101                                           101
101   101                                           101
101   1Z1                                           1Z1
1Z1   101                                           101
101   101                                           101
101   101                                           101
101   101                                           101
1011111011111111111111111111111111111111111111111111101
10000000000000000000000000Y000000000Z000000000000000001
1011111111111111111111111111111111111111111111111111111
101
101
1Z1
101
111