NO textures/wall_textures/wall.png
SO textures/wall_textures/wall2.png
WE textures/wall_textures/wall3.png
EA textures/wall_textures/wall4.png

F 220,100,0
C 225,30,0

111
1S1
101
101
101
101
101
101
1X1
101
101
101
101
101
101
101
101
101
101
101
101
101
101
101
1X1
101
10111
10001
11001
 1001
 1001
 1001
 1001
 1Y01
 1001
 1001
 1001
 1001
 1001
 1001
 1001
 1001
 1001
 1001
 1001
 1001
 10011
 10001
 10101
 101X1
 10101
 10101
 10101
 10101
 1X101
 10101
 10101
 10101
 10101
 10101
 10101
 10101
 10101
 10101
 10101
 10101
 10101111111
 10100000001
 10101111101
 10101   101
 1Y101   101
 101Y1   101
 10111   1Y1
 101  111101
 101  100001
 101  101111
 101  101
 101  101
 101  101
 101  101
 1X1  101
 101  101
 101  101
 101  101
 101  101
 101  101
 101  101
 101  101
 101  101
 101  101
1101  101
1001  101
1011111011111111111111111111111111111111111111111111111
100000000000Z000000000000000000000X000000000000000000X1
1011111011111111111111111111111111111111111111111111101
101   101                                           101
101   101                                           101
1X1   101                                           101
101   101                                           101
101   101                                           101
101   101                                           101
101   101                                           101
101   101                                           101
101   1X1                                           1X1
1X1   101                                           101
101   101                                           101
101   101                                           101
101   101                                           101
1011111011111111111111111111111111111111111111111111101
10000000000000000000000000Y000000000Z000000000000000001
1011111111111111111111111111111111111111111111111111111
101
101
1X1
101
111