NO txt/wall_textures/wall.png
EA txt/wall_textures/wall4.png
SO txt/wall_textures/wall2.png
WE txt/wall_textures/wall3.png

F 220,100,0
C 225,30,0

11111111111111111111111111111111111
100000000000000000000000000000X0001
100Y0000000000000000000000000000001
10000000110011111001111100111110001
10000000110000001000000100000100001
10000000110000011000001100000100001
10000011010001110Y00111000000100001
10000100010000010000011000000100001
10000000010000001000001000000100001
10000000010000011000001000001000001
10000000010001110000001000001000001
10000011111100000001110000001000001
10000000000000000000000000000000001
10000X00000000000000000000000000001
10000000000000000000000000000000001
10000000000000000000000000X00000001
10000000000000000000000000000000001
10000X00000000000N00000000000000001
10000000000000000000000000000000001
10000000000000000000000000000000001
10000000000000000000000000001000001
10000100000111110001111000010000001
10000100001100000001000000111110001
10000100001100000001110000001000001
10000100000111100000110000001000001
10000100000010000001000000001000001
100000100000110XZ010000000001000001
10000010000001100010000000001000001
10000010000000111010000000001000001
10000011110000000001111100000100001
10000000000000000000000000000000001
10000000000000000000000000000000001
1000000000000000X00000X0000X0000001
100000X0000000000000000000000000001
11111111111111111111111111111111111