NO txt/wall_textures/wall.png
EA txt/wall_textures/wall4.png
SO txt/wall_textures/wall2.png
WE txt/wall_textures/wall3.png

F 135,109,70
C 181,171,107

1111
1S01
1111